####################################################################################################
#.........####.############################################################################.######.#
#........................#######################.............................##############.######.#
#.........#############################################################################.###.######.#
#.........#############################################################################.###.######.#
#.........#############################################################################.###.######.#
#.#####################################################################################.###.######.#
#########.#############################################################################.###.######.#
#########.######################.######################################################.##########.#
#....................................................................##################.##########.#
#..................................................................................................#
#....................................................................##################.##########.#
#....................................................................####.#############.##########.#
#....................................................................####.#############.##########.#
#......##.###############.###########################.............####..................##########.#
#..............................................######.............####..................##########.#
#....................................################.............####..................##########.#
#....................................################.............####..................##########.#
#....................................################.............####..................##########.#
#....................................###############..............#######.#############.##########.#
#.........####.##########.##########################..............#######.########.................#
#.........###############..#########################.####################.#############.########.#.#
#....................................###############.####################.###......................#
#....................................###############.####################.#############.########.#.#
#....................................###############....................................########.#.#
#......................................#############....................................########.#.#
#......................................#############....................................########.#.#
#......................................#############......................................######.#.#
#......................................#############......................................######.#.#
#......................................#############.################.....................######.#.#
#......................................#############.################.....................######.#.#
#......................................#############.################.....................######.#.#
#......................................#############.################.....................######.#.#
#......................................###########.#.##############.#..............................#
#......................................###########.#.##############.#.....................######.#.#
#......................................######.####.#.##############.#.....................##.###.#.#
#.##.........#############.....................###.#.##############.#.....................##.###.#.#
#.................########.....................###.#.##############.#.....................##.###.#.#
#.............############......................................................############.###.#.#
#.##############................................................................############.#####.#
#.##############...............................................................................###.#
#..........#####................................................................###.#####..........#
#..........#####................................................................###.########.#####.#
#..........#####................................................................###.######.#.#####.#
#..........###############......................................................###.######.#.#####.#
#..........############################.........................................###.######.#.#####.#
#.######################........................................................###.######.#.#####.#
#.#######...........##########..................................................###.######.#.#####.#
#..................................................................................................#
#......##...........##########..................................................###.######.#.#####.#
#......##...........##########..................................................###.######.#.#####.#
#......##...........##########.............#...........##.#.###.#########.#########.######.#.#####.#
#......##...........##########.......#######...........##.#.###.#########.#########.######.#.#####.#
#.#######...........##########.......########.####.#.####.#.###.#########.#########.######.#.#####.#
#....................#######.#.............................................########.###.........##.#
#....................#######.#.............................................########.###.........##.#
#...................................................................................###.........##.#
#....................#######.#.............................................########.###.........##.#
#....................#######.#.............................................######...............##.#
#............###############.#.......##.....#####.......................#.#######.......##...#####.#
#........###################.#.......##.....#...........................#.#######.......##.#.#####.#
#........###################.#.......##.....#.................................###...............##.#
#........###################.#.......##.....#...........................#.#######...............##.#
#........#######.#############.......##.....#.............................#######...............##.#
#.##############.####................##.....#.............#.###.#######...#######...............##.#
#.##############.####................##.....#.............................#########.###.........##.#
#....................................#####.##.............................#########.###.........##.#
#.##############.####................#......................................#######.###.........##.#
#............###.####................#.......#............................#########.######.#.#####.#
#.#####.########.####................#.......#............................#########.######.#.#####.#
#.##############.####................#.......#............................#########.########.#####.#
#....................................#.......#.................................####.########.#####.#
#.##############.####................#.......#.....#...............###.........####.########.#####.#
#.##############.####.........######.#.......#.....#...............###.........####.###.........##.#
#.##############.####.........##.............#.....#...............###.........####.###.........##.#
#............................................#.....#...............###.........####.###.........##.#
#.##############.####.........######.#.......#.....#...............###.........####.###.........##.#
#.#########.####.####.........######.#.......#.....#...............###.........#.##.###.........##.#
#.#########.####.####.........######.#.......#.....#............................................##.#
#.#########.####..............######.#.......#.....#.....##.###.#######.#.######.##.###.........##.#
#.#########.####..............######.#.......#.....#.....##.###.######.........#.##.###.........##.#
#.#########.####..............######.#.......#.....#...............###.........#.##.###.........##.#
#.#########.####..............######.#####.###.....#...............###.........#.##.########.#####.#
#.#########.####..............######.#####.###.....#...............###.........#.##.########.#####.#
#.#########.####.####.........######.#####.#########...............###.........#.##.###.........##.#
#................................###.#####.#########...............###.........#.##.###.........##.#
#.#########.####.###################.#####.#########.....##.###.######.........#.##.###.........##.#
#.#########.####.###################.######################..##.######.........#.##.###.........##.#
#.#########.##############.........................................................................#
#............#######################.#####################......######.........#................##.#
#.#########.########################.#####################......######.........#................##.#
#.#########.########################.#####################......#...............................##.#
#.#########.########################.#####################......#######....#####................##.#
#.#########.########################.######################..##.#######....#####.......#####.#####.#
#.#########.########################.######################..##.#######....#####.###########.#####.#
#.....#####.###.##################.................................................................#
#.#########.###.####################.######################..##.#######....#####.###########.#####.#
#.#########.###.####################.######################..##.#######....#####.###########.#####.#
#..................................................................................................#
####################################################################################################
