####################################################################################################
#...............................................................................................##.#
#.....#######..##.##########..####...........#.####.................###..........#############.###.#
#.....######.........#######..####...........#.####.................###..........#############.###.#
#...............................................................................................##.#
#.....######.........#######..####.............####.................###..........#############.###.#
#.....######.........#######..####.............####.................###..........#############.###.#
#.....######.........##.......####.###.##.###..####.......#############..........#############.###.#
#.....#######..###.####.......########.##.###..#.######################..........#############.###.#
#.....#######..###.####.......########.##.###..#.######################..........#############.###.#
#.....#######..###.#.##.......########.##.##.............................................#####.###.#
#.###########..###.#.##.......#####..............................######..........#############.###.#
#.###########..#..............#####..............................#######.........#############.###.#
#.............................#####..............................###########.#################.###.#
#.###########.................#..................................###########.#######.....#####.###.#
#.###########................######..............................###########.#######.....#####.###.#
#.###########................#########.###.......................###########.#######.....#####.#.#.#
#.###########................#########.#####.....................###########.#######.....#####.#.#.#
#.###########..........................#####.....................###########.#######.....#####.#.#.#
#.###########..........................................................#####.#################.###.#
#.###########................#########.#####.....................###########.#################.###.#
#.###########..###.#.#######.#########.#####......................##########.#################.###.#
#.###########..###.#.#######.################.##.#####.........##.##########.#############...#.###.#
#.###########..###.###.#####.###...........................................#.#################.###.#
#.###########..###.#.......#.......................................................................#
#......######..###.#.......#.################.##.#####..........................##############.###.#
#......######..###.#.......#.################.##.#####..........................##############.###.#
#......######..###.#.......#.################.##.#####..........................##############.###.#
#......######..###.#...........####...........##.#####..........................##############.###.#
#......######..................####............................##.############################.###.#
#......####............#.......####............................##.#.########################.......#
#......####............#.......####............................##.#.###.###################.....##.#
#......####............#.......####...................###.......................###########.....##.#
#......####............#.......#......................###.......................###########.....##.#
#.#########............#.......####.............................................###########.....##.#
#.###########..###..##.#####.######.............................................###########.....##.#
#.###########..#.............######.............................................................##.#
#.###########..####.##.#####.##########.##.##.#.##.......##########.###.###################.....##.#
#.######.................###.##.....###.##.##.#.##...............##.###.###################.....##.#
#.##..........................................#.##...............##.###.###################.....##.#
#......#.................###...........###.##.#.##.........................###.....########.....##.#
#......#.................###.##.....######.#...............................###.....########.....##.#
#........................###.##.....######.#...............................###.....##.....#.....##.#
#........................###.##............................................###.....##.....#.....####
#........................###.##............................................###.....##.....#.....####
#.......##.....#######.#####.##............................................###.....##.....#.....####
#.......######.#######.#####.##....................................................................#
#.......##...........#.#####.##.............#..............................###.....##.....#.....##.#
#.......######.#######.#####.##.............#..............................###.....##.....#.....##.#
#.......######.#######.#####.##.............#..............................#######.##.....#.....##.#
#.......######.#############.##.............#..............................#######.##.....########.#
#.......######.#############.##............................................#######.##.....########.#
#.......######.#############.##.............#..............................#######.##.....########.#
#.......######.#############.##.............#.....#######..................#######.##.....########.#
#.......##.###.#####.#######.##.............#.....#######..................#######.##.....########.#
#........................######.............#.....#######..................#######.##.....########.#
#........................######.............#.....#######..................#######.##.....########.#
#........................######.............#.....#######..................#######.##.....########.#
#........................######.............#...............................######.##.....########.#
#........................##########.........#.....#######.......##################.##.....########.#
#........................##########.........#.....#######.......##################.##.....########.#
#.######.................##########.........#.....#######.......##################.##.....########.#
#.######.................###.######.........#.....############.###################.##.....########.#
#.######.................###.######.........#.....############.###################.##.....########.#
#.######.................###.######.........#.....################################.##.....########.#
#.######.................###.######.........#.....##########################.#####.##.....########.#
#.######.................###.######.........#.....#.....####################.#####.##.....########.#
#.######.................###.######.........#.....#.....####################.########.....########.#
#.######.................###.######.........#.....#.....####################.########.....########.#
#..................#.#######.######.........#.#.###.....####################.#####################.#
#.########.#....................########.#.##.#.....................########.#############.#######.#
#.########.#....................########.#.##.#............####.....########.#############.#######.#
#.#####...........................######.#.##.#............####.....########.#############.#######.#
#.########.#....................########.#.##.#............##......................................#
#.########.#....................########.#.##.#............####.....########.#############.#######.#
#.########.#....................########.#.##.#............####.....########.##....................#
#.########.#....................########.#.##.#............####.....########.#############.#######.#
#.########.#########.####.##.#####..................................########.#############.#######.#
#......###.#########.####.##.###########.#.##.#............####.....########.#############.#######.#
#.########.#########.####.##.###########.#.##.#............####.....########.#############.#######.#
#.####.................##.##.###########.#.##.#............####.....########.#############.#######.#
#.########.#########.####.##.###########.#.##.#.############################.#############.#######.#
#.########.########.............########.#.##.#.############.....................................#.#
#.########.#########.####.##.###########.#.##.#.############################.#############.#######.#
#.########.#########.#.............................................................................#
#.########.######.##.####.............................................######.#############.#######.#
#.########.######.##.####.............................................######.#############.#######.#
#.########.######.##.####.............................................######.#############.#######.#
#....................####.............................................#...............####.#######.#
#....................####.#########.........#.################.....####...............####.#######.#
#....................####.#########.........#.################.....####...............####.#######.#
#....................####.##.######....................#######........................####.#######.#
#....................#######.######....................#######........................####.#####.#.#
#.########.######.##########.###########...............#######........................####.#####.#.#
#.########.######.###.######.###########...............##.####........................####.#####.#.#
#.########.##..............#.###########...............##.####........................####.#####.#.#
#.#######.........###.#####...................................................................##.#.#
#.....................................##.#.##############.######################.#########.#####.#.#
#...................#.###..........................................................................#
####################################################################################################
